"a" = (/turf/space,/area/space)
"." = (/turf/simulated/floor/asteroid,/area/space)
"m" = (/turf/simulated/mineral,/area/space)
"o" = (/obj/structure/ore_box,/turf/simulated/floor/asteroid,/area/space)
"r" = (/obj/random/maintenance,/turf/simulated/floor/asteroid,/area/space)

(1,1,1) = {"
 aaaaaaaaaaaa
 aaaa.....aaa
 aaa..mmm..aa
 aa..m.o.m.aa
 aa..mmrmm.aa
 aa..m.o.m.aa
 aaa..mmm..aa
 aaaa.....aaa
 aaaaaaaaaaaa
 aaaaaaaaaaaa
 aaaaaaaaaaaa
 aaaaaaaaaaaa
"}
