"a" = (/turf/space,/area/space)
"g" = (/obj/structure/grille,/turf/simulated/floor/airless,/area/space)
"w" = (/turf/simulated/wall,/area/space)
"r" = (/obj/random/maintenance,/turf/simulated/floor/airless,/area/space)

(1,1,1) = {"
 aaaaaaaaaaa
 aaagggggaaa
 aagwrrrwgaa
 aagw..rwgaa
 aagwrrrwgaa
 aaagggggaaa
 aaaaaaaaaaa
 aaaaaaaaaaa
 aaaaaaaaaaa
 aaaaaaaaaaa
 aaaaaaaaaaa
 aaaaaaaaaaa
"}
