"a" = (/turf/space,/area/space)
"u" = (/turf/simulated/floor/tiled/techfloor/grid,/area/space)
"w" = (/turf/simulated/wall,/area/space)
"t" = (/obj/structure/table/standard,/turf/simulated/floor/tiled/techfloor/grid,/area/space)
"l" = (/obj/machinery/light/small,/turf/simulated/floor/tiled/techfloor/grid,/area/space)
"c" = (/obj/structure/closet/crate,/turf/simulated/floor/tiled/techfloor/grid,/area/space)
"r" = (/obj/random/maintenance,/turf/simulated/floor/tiled/techfloor/grid,/area/space)

(1,1,1) = {"
 aaaaaaaaaaaaaa
 aaaaawwwwaaaa
 aaaawuuuuwaaa
 aaawutclu...a
 aaawuuuuwa.aa
 aaaawuwuwaaaa
 aaaaawwwwaaaa
 aaaaaaaaaaaaaa
 aaaaaaaaaaaaaa
 aaaaaaaaaaaaaa
 aaaaaaaaaaaaaa
 aaaaaaaaaaaaaa
"}
