"a" = (/turf/space,/area/space)
"f" = (/obj/structure/window/reinforced,/turf/space,/area/space)
"g" = (/obj/structure/grille,/turf/simulated/floor/airless,/area/space)

(1,1,1) = {"
 aaaaaaaaaaaa
 aaff..ffaaaa
 aag....gaaaa
 aaff..ffaaaa
 aag....gaaaa
 aaff..ffaaaa
 aaaaaaaaaaaa
 aaaaaaaaaaaa
 aaaaaaaaaaaa
 aaaaaaaaaaaa
 aaaaaaaaaaaa
 aaaaaaaaaaaa
"}
