"a" = (/turf/space,/area/space)
"g" = (/obj/structure/grille,/turf/simulated/floor/airless,/area/space)
"f" = (/obj/structure/window/reinforced,/turf/space,/area/space)
"r" = (/obj/random/maintenance,/turf/simulated/floor/airless,/area/space)

(1,1,1) = {"
 aaaaaaaaaaaa
 aaffggffaaaa
 aag.r..gaaaa
 aag....gaaaa
 aag..r.gaaaa
 aaffggffaaaa
 aaaaaaaaaaaa
 aaaaaaaaaaaa
 aaaaaaaaaaaa
 aaaaaaaaaaaa
 aaaaaaaaaaaa
 aaaaaaaaaaaa
"}
